XXXXDDXXXX
XXXXDDXXXX
XXXXXXXXXX
XXXXXXXXXX
XXXXXXXXXX
|XXXXXXXX|
||CXXXXC||
|||XXXX|||
||||DD||||
||||DD||||